12222222221
01222222110
00122222100
00012221000
00001210000
00000100000