1222222221
0122222210
0012222100
0001221000
0000110000