0000000000
0111111110
0112222110
0112222110
0111111110